a	a
ai	a i
an	a n
ang	a ŋ
ao	a u
ba	p a
bai	p a i
ban	p a n
bang	p a ŋ
bao	p a u
bei	p e i
ben	p ə n
beng	p ə ŋ
bi	p i
bian	p i ɛ n
biao	p i a u
bie	p i e
bin	p i n
bing	p i ŋ
bo	p u o
bu	p u
ca	tsʰ a
cai	tsʰ a i
can	tsʰ a n
cang	tsʰ a ŋ
cao	tsʰ a u
ce	tsʰ ɤ
cen	tsʰ ə n
ceng	tsʰ ə ŋ
cha	tʂʰ a
chai	tʂʰ a i
chan	tʂʰ a n
chang	tʂʰ a ŋ
chao	tʂʰ a u
che	tʂʰ ɤ
chen	tʂʰ ə n
cheng	tʂʰ ə ŋ
chi	tʂʰ ɨ
chong	tʂʰ ʊ ŋ
chou	tʂʰ o u
chu	tʂʰ u
chua	tʂʰ u a
chuai	tʂʰ u a i
chuan	tʂʰ u a n
chuang	tʂʰ u a ŋ
chui	tʂʰ u e i
chun	tʂʰ u ə n
chuo	tʂʰ u o
ci	tsʰ ɨ
cong	tsʰ ʊ ŋ
cou	tsʰ o u
cu	tsʰ u
cuan	tsʰ u a n
cui	tsʰ u e i
cun	tsʰ u ə n
cuo	tsʰ u o
da	t a
dai	t a i
dan	t a n
dang	t a ŋ
dao	t a u
de	t ɤ
dei	t e i
den	t ə n
deng	t ə ŋ
di	t i
dian	t i ɛ n
diang	t i a ŋ
diao	t i a u
die	t i e
ding	t i ŋ
diu	t i o u
dong	t ʊ ŋ
dou	t o u
du	t u
duan	t u a n
dui	t u e i
dun	t u ə n
duo	t u o
e	ɤ
ê	ɛ
ei	e i
en	ə n
eng	ə ŋ
er	a ɚ
fa	f a
fan	f a n
fang	f a ŋ
fei	f e i
fen	f ə n
feng	f ə ŋ
fo	f u o
fou	f o u
fu	f u
ga	k a
gai	k a i
gan	k a n
gang	k a ŋ
gao	k a u
ge	k ɤ
gei	k e i
gen	k ə n
geng	k ə ŋ
gong	k ʊ ŋ
gou	k o u
gu	k u
gua	k u a
guai	k u a i
guan	k u a n
guang	k u a ŋ
gui	k u e i
gun	k u ə n
guo	k u o
ha	x a
hai	x a i
han	x a n
hang	x a ŋ
hao	x a u
he	x ɤ
hei	x e i
hen	x ə n
heng	x ə ŋ
hong	x ʊ ŋ
hou	x o u
hu	x u
hua	x u a
huai	x u a i
huan	x u a n
huang	x u a ŋ
hui	x u e i
hun	x u ə n
huo	x u o
ji	tɕ i
jia	tɕ i a
jian	tɕ i ɛ n
jiang	tɕ i a ŋ
jiao	tɕ i a u
jie	tɕ i e
jin	tɕ i n
jing	tɕ i ŋ
jiong	tɕ i ʊ ŋ
jiu	tɕ i o u
ju	tɕ y
juan	tɕ y ɛ n
jue	tɕ y e
jun	tɕ y n
ka	kʰ a
kai	kʰ a i
kan	kʰ a n
kang	kʰ a ŋ
kao	kʰ a u
ke	kʰ ɤ
kei	kʰ e i
ken	kʰ ə n
keng	kʰ ə ŋ
kong	kʰ ʊ ŋ
kou	kʰ o u
ku	kʰ u
kua	kʰ u a
kuai	kʰ u a i
kuan	kʰ u a n
kuang	kʰ u a ŋ
kui	kʰ u e i
kun	kʰ u ə n
kuo	kʰ u o
la	l a
lai	l a i
lan	l a n
lang	l a ŋ
lao	l a u
le	l ɤ
lei	l e i
leng	l ə ŋ
li	l i
lia	l i a
lian	l i ɛ n
liang	l i a ŋ
liao	l i a u
lie	l i e
lin	l i n
ling	l i ŋ
liu	l i o u
lo	l ɔ
long	l ʊ ŋ
lou	l o u
lu	l u
lü	l y
lv	l y
luan	l u a n
lüan	l y ɛ n
lüe	l y e
lue	l y e
lun	l u ə n
lün	l y n
luo	l u o
ma	m a
mai	m a i
man	m a n
mang	m a ŋ
mao	m a u
me	m ɤ
mei	m e i
men	m ə n
meng	m ə ŋ
mi	m i
mian	m i ɛ n
miao	m i a u
mie	m i e
min	m i n
ming	m i ŋ
miu	m i o u
mo	m u o
mou	m o u
mu	m u
na	n a
nai	n a i
nan	n a n
nang	n a ŋ
nao	n a u
ne	n ɤ
nei	n e i
nen	n ə n
neng	n ə ŋ
ni	n i
nia	n i a
nian	n i ɛ n
niang	n i a ŋ
niao	n i a u
nie	n i e
nin	n i n
ning	n i ŋ
niu	n i o u
nong	n ʊ ŋ
nou	n o u
nu	n u
nü	n y
nv	n y
nuan	n u a n
nüe	n y e
nve	n y e
nun	n u ə n
nuo	n u o
o	ɔ
ou	o u
pa	pʰ a
pai	pʰ a i
pan	pʰ a n
pang	pʰ a ŋ
pao	pʰ a u
pei	pʰ e i
pen	pʰ ə n
peng	pʰ ə ŋ
pi	pʰ i
pian	pʰ i ɛ n
piao	pʰ i a u
pie	pʰ i e
pin	pʰ i n
ping	pʰ i ŋ
po	pʰ u o
pou	pʰ o u
pu	pʰ u
qi	tɕʰ i
qia	tɕʰ i a
qian	tɕʰ i ɛ n
qiang	tɕʰ i a ŋ
qiao	tɕʰ i a u
qie	tɕʰ i e
qin	tɕʰ i n
qing	tɕʰ i ŋ
qiong	tɕʰ i ʊ ŋ
qiu	tɕʰ i o u
qu	tɕʰ y
quan	tɕʰ y ɛ n
que	tɕʰ y e
qun	tɕʰ y n
ran	ɻ a n
rang	ɻ a ŋ
rao	ɻ a u
re	ɻ ɤ
ren	ɻ ə n
reng	ɻ ə ŋ
ri	ɻ ɨ
rong	ɻ ʊ ŋ
rou	ɻ o u
ru	ɻ u
ruan	ɻ u a n
rui	ɻ u e i
run	ɻ u ə n
ruo	ɻ u o
sa	s a
sai	s a i
san	s a n
sang	s a ŋ
sao	s a u
se	s ɤ
sei	s e i
sen	s ə n
seng	s ə ŋ
sha	ʂ a
shai	ʂ a i
shan	ʂ a n
shang	ʂ a ŋ
shao	ʂ a u
she	ʂ ɤ
shei	ʂ e i
shen	ʂ ə n
sheng	ʂ ə ŋ
shi	ʂ ɨ
shong	ʂ ʊ ŋ
shou	ʂ o u
shu	ʂ u
shua	ʂ u a
shuai	ʂ u a i
shuan	ʂ u a n
shuang	ʂ u a ŋ
shui	ʂ u e i
shun	ʂ u ə n
shuo	ʂ u o
si	s ɨ
song	s ʊ ŋ
sou	s o u
su	s u
suan	s u a n
sui	s u e i
sun	s u ə n
suo	s u o
ta	tʰ a
tai	tʰ a i
tan	tʰ a n
tang	tʰ a ŋ
tao	tʰ a u
te	tʰ ɤ
tei	tʰ e i
teng	tʰ ə ŋ
ti	tʰ i
tian	tʰ i ɛ n
tiao	tʰ i a u
tie	tʰ i e
ting	tʰ i ŋ
tong	tʰ ʊ ŋ
tou	tʰ o u
tu	tʰ u
tuan	tʰ u a n
tui	tʰ u e i
tun	tʰ u ə n
tuo	tʰ u o
wa	u a
wai	u a i
wan	u a n
wang	u a ŋ
wei	u e i
wen	u ə n
weng	u ə ŋ
wo	u o
wu	u
xi	ɕ i
xia	ɕ i a
xian	ɕ i ɛ n
xiang	ɕ i a ŋ
xiao	ɕ i a u
xie	ɕ i e
xin	ɕ i n
xing	ɕ i ŋ
xiong	ɕ i ʊ ŋ
xiu	ɕ i o u
xu	ɕ y
xuan	ɕ y ɛ n
xue	ɕ y e
xun	ɕ y n
ya	i a
yan	i ɛ n
yang	i a ŋ
yao	i a u
ye	i e
yi	i
yin	i n
ying	i ŋ
yong	i ʊ ŋ
you	i o u
yo	i o u
yu	y
yuan	y ɛ n
yue	y e
yun	y n
za	ts a
zai	ts a i
zan	ts a n
zang	ts a ŋ
zao	ts a u
ze	ts ɤ
zei	ts e i
zen	ts ə n
zeng	ts ə ŋ
zha	tʂ a
zhai	tʂ a i
zhan	tʂ a n
zhang	tʂ a ŋ
zhao	tʂ a u
zhe	tʂ ɤ
zhei	tʂ e i
zhen	tʂ ə n
zheng	tʂ ə ŋ
zhi	tʂ ɨ
zhong	tʂ ʊ ŋ
zhou	tʂ o u
zhu	tʂ u
zhua	tʂ u a
zhuai	tʂ u a i
zhuan	tʂ u a n
zhuang	tʂ u a ŋ
zhui	tʂ u e i
zhun	tʂ u ə n
zhuo	tʂ u o
zi	ts ɨ
zong	ts ʊ ŋ
zou	ts o u
zu	ts u
zuan	ts u a n
zui	ts u e i
zun	ts u ə n
zuo	ts u o
SP	SP
AP	AP