zhi	tʂ ɻ̍
chi	tʂʰ ɻ̍
shi	ʂ ɻ̍
ri	ɻ ɻ̍
zi	ts ɹ̩
ci	tsʰ ɹ̩
si	s ɹ̩
ba	p a
pa	pʰ a
ma	m a
fa	f a
da	t a
ta	tʰ a
na	n a
la	l a
ga	k a
ka	kʰ a
ha	x a
zha	tʂ a
cha	tʂʰ a
sha	ʂ a
ra	ɻ a
za	ts a
ca	tsʰ a
sa	s a
bo	p uo
po	pʰ uo
mo	m uo
fo	f uo
do	t o
to	tʰ o
no	n o
lo	l o
go	k o
ko	kʰ o
ho	x o
zho	tʂ o
cho	tʂʰ o
sho	ʂ o
ro	ɻ o
zo	ts o
co	tsʰ o
so	s o
be	p ɤ
pe	pʰ ɤ
me	m ɤ
fe	f ɤ
de	t ɤ
te	tʰ ɤ
ne	n ɤ
le	l ɤ
ge	k ɤ
ke	kʰ ɤ
he	x ɤ
zhe	tʂ ɤ
che	tʂʰ ɤ
she	ʂ ɤ
re	ɻ ɤ
ze	ts ɤ
ce	tsʰ ɤ
se	s ɤ
bai	p a i
pai	pʰ a i
mai	m a i
fai	f a i
dai	t a i
tai	tʰ a i
nai	n a i
lai	l a i
gai	k a i
kai	kʰ a i
hai	x a i
zhai	tʂ a i
chai	tʂʰ a i
shai	ʂ a i
rai	ɻ a i
zai	ts a i
cai	tsʰ a i
sai	s a i
bei	p e i
pei	pʰ e i
mei	m e i
fei	f e i
dei	t e i
tei	tʰ e i
nei	n e i
lei	l e i
gei	k e i
kei	kʰ e i
hei	x e i
zhei	tʂ e i
chei	tʂʰ e i
shei	ʂ e i
rei	ɻ e i
zei	ts e i
cei	tsʰ e i
sei	s e i
bao	p au
pao	pʰ au
mao	m au
fao	f au
dao	t au
tao	tʰ au
nao	n au
lao	l au
gao	k au
kao	kʰ au
hao	x au
zhao	tʂ au
chao	tʂʰ au
shao	ʂ au
rao	ɻ au
zao	ts au
cao	tsʰ au
sao	s au
bou	p  ou
pou	pʰ  ou
mou	m  ou
fou	f  ou
dou	t  ou
tou	tʰ  ou
nou	n  ou
lou	l  ou
gou	k  ou
kou	kʰ  ou
hou	x  ou
zhou	tʂ  ou
chou	tʂʰ  ou
shou	ʂ  ou
rou	ɻ  ou
zou	ts  ou
cou	tsʰ  ou
sou	s  ou
ban	p a n
pan	pʰ a n
man	m a n
fan	f a n
dan	t a n
tan	tʰ a n
nan	n a n
lan	l a n
gan	k a n
kan	kʰ a n
han	x a n
zhan	tʂ a n
chan	tʂʰ a n
shan	ʂ a n
ran	ɻ a n
zan	ts a n
can	tsʰ a n
san	s a n
ben	p ə n
pen	pʰ ə n
men	m ə n
fen	f ə n
den	t ə n
ten	tʰ ə n
nen	n ə n
len	l ə n
gen	k ə n
ken	kʰ ə n
hen	x ə n
zhen	tʂ ə n
chen	tʂʰ ə n
shen	ʂ ə n
ren	ɻ ə n
zen	ts ə n
cen	tsʰ ə n
sen	s ə n
bang	p a ŋ
pang	pʰ a ŋ
mang	m a ŋ
fang	f a ŋ
dang	t a ŋ
tang	tʰ a ŋ
nang	n a ŋ
lang	l a ŋ
gang	k a ŋ
kang	kʰ a ŋ
hang	x a ŋ
zhang	tʂ a ŋ
chang	tʂʰ a ŋ
shang	ʂ a ŋ
rang	ɻ a ŋ
zang	ts a ŋ
cang	tsʰ a ŋ
sang	s a ŋ
beng	p ə n
peng	pʰ ə n
meng	m ə n
feng	f ə n
deng	t ə n
teng	tʰ ə n
neng	n ə n
leng	l ə n
geng	k ə n
keng	kʰ ə n
heng	x ə n
zheng	tʂ ə n
cheng	tʂʰ ə n
sheng	ʂ ə n
reng	ɻ ə n
zeng	ts ə n
ceng	tsʰ ə n
seng	s ə n
bi	p i
pi	pʰ i
mi	m i
fi	f i
di	t i
ti	tʰ i
ni	n i
li	l i
gi	k i
ki	kʰ i
hi	x i
ji	tɕ i
qi	tɕʰ i
xi	ɕ i
bia	p ia
pia	pʰ ia
mia	m ia
fia	f ia
dia	t ia
tia	tʰ ia
nia	n ia
lia	l ia
gia	k ia
kia	kʰ ia
hia	x ia
jia	tɕ ia
qia	tɕʰ ia
xia	ɕ ia
bio	p iau
pio	pʰ iau
mio	m iau
fio	f iau
dio	t iau
tio	tʰ iau
nio	n iau
lio	l iau
gio	k iau
kio	kʰ iau
hio	x iau
jio	tɕ iau
qio	tɕʰ iau
xio	ɕ iau
bie	p ie
pie	pʰ ie
mie	m ie
fie	f ie
die	t ie
tie	tʰ ie
nie	n ie
lie	l ie
gie	k ie
kie	kʰ ie
hie	x ie
jie	tɕ ie
qie	tɕʰ ie
xie	ɕ ie
biai	p ia i
piai	pʰ ia i
miai	m ia i
fiai	f ia i
diai	t ia i
tiai	tʰ ia i
niai	n ia i
liai	l ia i
giai	k ia i
kiai	kʰ ia i
hiai	x ia i
jiai	tɕ ia i
qiai	tɕʰ ia i
xiai	ɕ ia i
biao	p iau
piao	pʰ iau
miao	m iau
fiao	f iau
diao	t iau
tiao	tʰ iau
niao	n iau
liao	l iau
giao	k iau
kiao	kʰ iau
hiao	x iau
jiao	tɕ iau
qiao	tɕʰ iau
xiao	ɕ iau
biu	p i ou
piu	pʰ i ou
miu	m i ou
fiu	f i ou
diu	t i ou
tiu	tʰ i ou
niu	n i ou
liu	l i ou
giu	k i ou
kiu	kʰ i ou
hiu	x i ou
jiu	tɕ i ou
qiu	tɕʰ i ou
xiu	ɕ i ou
bian	p iɛ n
pian	pʰ iɛ n
mian	m iɛ n
fian	f iɛ n
dian	t iɛ n
tian	tʰ iɛ n
nian	n iɛ n
lian	l iɛ n
gian	k iɛ n
kian	kʰ iɛ n
hian	x iɛ n
jian	tɕ iɛ n
qian	tɕʰ iɛ n
xian	ɕ iɛ n
bin	p i n
pin	pʰ i n
min	m i n
fin	f i n
din	t i n
tin	tʰ i n
nin	n i n
lin	l i n
gin	k i n
kin	kʰ i n
hin	x i n
jin	tɕ i n
qin	tɕʰ i n
xin	ɕ i n
biang	p ia ŋ
piang	pʰ ia ŋ
miang	m ia ŋ
fiang	f ia ŋ
diang	t ia ŋ
tiang	tʰ ia ŋ
niang	n ia ŋ
liang	l ia ŋ
giang	k ia ŋ
kiang	kʰ ia ŋ
hiang	x ia ŋ
jiang	tɕ ia ŋ
qiang	tɕʰ ia ŋ
xiang	ɕ ia ŋ
bing	p i ŋ
ping	pʰ i ŋ
ming	m i ŋ
fing	f i ŋ
ding	t i ŋ
ting	tʰ i ŋ
ning	n i ŋ
ling	l i ŋ
ging	k i ŋ
king	kʰ i ŋ
hing	x i ŋ
jing	tɕ i ŋ
qing	tɕʰ i ŋ
xing	ɕ i ŋ
bu	p u
pu	pʰ u
mu	m u
fu	f u
du	t u
tu	tʰ u
nu	n u
lu	l u
gu	k u
ku	kʰ u
hu	x u
ju	tɕ y
qu	tɕʰ y
xu	ɕ y
zhu	tʂ u
chu	tʂʰ u
shu	ʂ u
ru	ɻ u
zu	ts u
cu	tsʰ u
su	s u
bua	p ua
pua	pʰ ua
mua	m ua
fua	f ua
dua	t ua
tua	tʰ ua
nua	n ua
lua	l ua
gua	k ua
kua	kʰ ua
hua	x ua
jua	tɕ ua
qua	tɕʰ ua
xua	ɕ ua
zhua	tʂ ua
chua	tʂʰ ua
shua	ʂ ua
rua	ɻ ua
zua	ts ua
cua	tsʰ ua
sua	s ua
buo	p uo
puo	pʰ uo
muo	m uo
fuo	f uo
duo	t uo
tuo	tʰ uo
nuo	n uo
luo	l uo
guo	k uo
kuo	kʰ uo
huo	x uo
juo	tɕ uo
quo	tɕʰ uo
xuo	ɕ uo
zhuo	tʂ uo
chuo	tʂʰ uo
shuo	ʂ uo
ruo	ɻ uo
zuo	ts uo
cuo	tsʰ uo
suo	s uo
buai	p ua i
puai	pʰ ua i
muai	m ua i
fuai	f ua i
duai	t ua i
tuai	tʰ ua i
nuai	n ua i
luai	l ua i
guai	k ua i
kuai	kʰ ua i
huai	x ua i
juai	tɕ ua i
quai	tɕʰ ua i
xuai	ɕ ua i
zhuai	tʂ ua i
chuai	tʂʰ ua i
shuai	ʂ ua i
ruai	ɻ ua i
zuai	ts ua i
cuai	tsʰ ua i
suai	s ua i
bui	p ue i
pui	pʰ ue i
mui	m ue i
fui	f ue i
dui	t ue i
tui	tʰ ue i
nui	n ue i
lui	l ue i
gui	k ue i
kui	kʰ ue i
hui	x ue i
jui	tɕ ue i
qui	tɕʰ ue i
xui	ɕ ue i
zhui	tʂ ue i
chui	tʂʰ ue i
shui	ʂ ue i
rui	ɻ ue i
zui	ts ue i
cui	tsʰ ue i
sui	s ue i
buan	p ua n
puan	pʰ ua n
muan	m ua n
fuan	f ua n
duan	t ua n
tuan	tʰ ua n
nuan	n ua n
luan	l ua n
guan	k ua n
kuan	kʰ ua n
huan	x ua n
juan	tɕ yɛ n
quan	tɕʰ yɛ n
xuan	ɕ yɛ n
zhuan	tʂ ua n
chuan	tʂʰ ua n
shuan	ʂ ua n
ruan	ɻ ua n
zuan	ts ua n
cuan	tsʰ ua n
suan	s ua n
bun	p uə n
pun	pʰ uə n
mun	m uə n
fun	f uə n
dun	t uə n
tun	tʰ uə n
nun	n uə n
lun	l uə n
gun	k uə n
kun	kʰ uə n
hun	x uə n
jun	tɕ y n
qun	tɕʰ y n
xun	ɕ y n
zhun	tʂ uə n
chun	tʂʰ uə n
shun	ʂ uə n
run	ɻ uə n
zun	ts uə n
cun	tsʰ uə n
sun	s uə n
buang	p ua ŋ
puang	pʰ ua ŋ
muang	m ua ŋ
fuang	f ua ŋ
duang	t ua ŋ
tuang	tʰ ua ŋ
nuang	n ua ŋ
luang	l ua ŋ
guang	k ua ŋ
kuang	kʰ ua ŋ
huang	x ua ŋ
juang	tɕ ua ŋ
quang	tɕʰ ua ŋ
xuang	ɕ ua ŋ
zhuang	tʂ ua ŋ
chuang	tʂʰ ua ŋ
shuang	ʂ ua ŋ
ruang	ɻ ua ŋ
zuang	ts ua ŋ
cuang	tsʰ ua ŋ
suang	s ua ŋ
bong	p ʊ ŋ
pong	pʰ ʊ ŋ
mong	m ʊ ŋ
fong	f ʊ ŋ
dong	t ʊ ŋ
tong	tʰ ʊ ŋ
nong	n ʊ ŋ
long	l ʊ ŋ
gong	k ʊ ŋ
kong	kʰ ʊ ŋ
hong	x ʊ ŋ
zhong	tʂ ʊ ŋ
chong	tʂʰ ʊ ŋ
shong	ʂ ʊ ŋ
rong	ɻ ʊ ŋ
zong	ts ʊ ŋ
cong	tsʰ ʊ ŋ
song	s ʊ ŋ
bv	p y
byu	p y
pv	pʰ y
pyu	pʰ y
mv	m y
myu	m y
fv	f y
fyu	f y
dv	t y
dyu	t y
tv	tʰ y
tyu	tʰ y
nv	n y
nyu	n y
lv	l y
lyu	l y
gv	k y
gyu	k y
kv	kʰ y
kyu	kʰ y
hv	x y
hyu	x y
jv	tɕ y
jyu	tɕ y
qv	tɕʰ y
qyu	tɕʰ y
xv	ɕ y
xyu	ɕ y
zhv	tʂ y
zhyu	tʂ y
chv	tʂʰ y
chyu	tʂʰ y
shv	ʂ y
shyu	ʂ y
rv	ɻ y
ryu	ɻ y
zv	ts y
zyu	ts y
cv	tsʰ y
cyu	tsʰ y
sv	s y
syu	s y
bve	p ye
bue	p ye
pve	pʰ ye
pue	pʰ ye
mve	m ye
mue	m ye
fve	f ye
fue	f ye
dve	t ye
due	t ye
tve	tʰ ye
tue	tʰ ye
nve	n ye
nue	n ye
lve	l ye
lue	l ye
gve	k ye
gue	k ye
kve	kʰ ye
kue	kʰ ye
hve	x ye
hue	x ye
jve	tɕ ye
jue	tɕ ye
qve	tɕʰ ye
que	tɕʰ ye
xve	ɕ ye
xue	ɕ ye
zhve	tʂ ye
zhue	tʂ ye
chve	tʂʰ ye
chue	tʂʰ ye
shve	ʂ ye
shue	ʂ ye
rve	ɻ ye
rue	ɻ ye
zve	ts ye
zue	ts ye
cve	tsʰ ye
cue	tsʰ ye
sve	s ye
sue	s ye
biong	p iʊ ŋ
piong	pʰ iʊ ŋ
miong	m iʊ ŋ
fiong	f iʊ ŋ
diong	t iʊ ŋ
tiong	tʰ iʊ ŋ
niong	n iʊ ŋ
liong	l iʊ ŋ
giong	k iʊ ŋ
kiong	kʰ iʊ ŋ
hiong	x iʊ ŋ
jiong	tɕ iʊ ŋ
qiong	tɕʰ iʊ ŋ
xiong	ɕ iʊ ŋ
zhiong	tʂ iʊ ŋ
chiong	tʂʰ iʊ ŋ
shiong	ʂ iʊ ŋ
riong	ɻ iʊ ŋ
ziong	ts iʊ ŋ
ciong	tsʰ iʊ ŋ
siong	s iʊ ŋ
a	a
o	o
e	ɤ
ai	a i
ei	e i
ao	au
ou	 ou
an	a n
en	ə n
ang	a ŋ
ong	ʊ ŋ
eng	ə ŋ
er	a ɚ
i	i
u	u
v	y
yi	i
wu	u
yu	y
ya	∅ ia
ia	∅ ia
yo	∅ iau
io	∅ iau
ye	∅ ie
ie	∅ ie
yai	∅ ia i
iai	∅ ia i
yao	∅ iau
iao	∅ iau
you	∅ i ou
iou	∅ i ou
yan	∅ iɛ n
ian	∅ iɛ n
yin	∅ i n
in	∅ i n
yang	∅ ia ŋ
iang	∅ ia ŋ
ying	∅ i ŋ
ing	∅ i ŋ
wa	w ua
ua	w ua
wo	w uo
uo	w uo
wai	w ua i
uai	w ua i
wei	w ue i
wui	w ue i
ui	w ue i
wan	w ua n
uan	w ua n
wen	w uə n
uen	w uə n
wang	w ua ŋ
uang	w ua ŋ
weng	w uə ŋ
wong	w ʊ ŋ
yue	∅ ye
ue	∅ ye
yve	∅ ye
ve	∅ ye
yuan	∅ yɛ n
van	∅ yɛ n
yun	∅ y n
vn	∅ y n
yong	∅ iʊ ŋ
iong	∅ iʊ ŋ
