zhi	tʂ ɻ̍
chi	tʂʰ ɻ̍
shi	ʂ ɻ̍
ri	ɻ ɻ̍
zi	ts ɹ̩
ci	tsʰ ɹ̩
si	s ɹ̩
ba	p a
pa	pʰ a
ma	m a
fa	f a
da	t a
ta	tʰ a
na	n a
la	l a
ga	k a
ka	kʰ a
ha	x a
zha	tʂ a
cha	tʂʰ a
sha	ʂ a
ra	ɻ a
za	ts a
ca	tsʰ a
sa	s a
bo	p uo
po	pʰ uo
mo	m uo
fo	f uo
do	t o
to	tʰ o
no	n o
lo	l o
go	k o
ko	kʰ o
ho	x o
zho	tʂ o
cho	tʂʰ o
sho	ʂ o
ro	ɻ o
zo	ts o
co	tsʰ o
so	s o
be	p ɤ
pe	pʰ ɤ
me	m ɤ
fe	f ɤ
de	t ɤ
te	tʰ ɤ
ne	n ɤ
le	l ɤ
ge	k ɤ
ke	kʰ ɤ
he	x ɤ
zhe	tʂ ɤ
che	tʂʰ ɤ
she	ʂ ɤ
re	ɻ ɤ
ze	ts ɤ
ce	tsʰ ɤ
se	s ɤ
bai	p ai
pai	pʰ ai
mai	m ai
fai	f ai
dai	t ai
tai	tʰ ai
nai	n ai
lai	l ai
gai	k ai
kai	kʰ ai
hai	x ai
zhai	tʂ ai
chai	tʂʰ ai
shai	ʂ ai
rai	ɻ ai
zai	ts ai
cai	tsʰ ai
sai	s ai
bei	p ei
pei	pʰ ei
mei	m ei
fei	f ei
dei	t ei
tei	tʰ ei
nei	n ei
lei	l ei
gei	k ei
kei	kʰ ei
hei	x ei
zhei	tʂ ei
chei	tʂʰ ei
shei	ʂ ei
rei	ɻ ei
zei	ts ei
cei	tsʰ ei
sei	s ei
bao	p au
pao	pʰ au
mao	m au
fao	f au
dao	t au
tao	tʰ au
nao	n au
lao	l au
gao	k au
kao	kʰ au
hao	x au
zhao	tʂ au
chao	tʂʰ au
shao	ʂ au
rao	ɻ au
zao	ts au
cao	tsʰ au
sao	s au
bou	p  ou
pou	pʰ  ou
mou	m  ou
fou	f  ou
dou	t  ou
tou	tʰ  ou
nou	n  ou
lou	l  ou
gou	k  ou
kou	kʰ  ou
hou	x  ou
zhou	tʂ  ou
chou	tʂʰ  ou
shou	ʂ  ou
rou	ɻ  ou
zou	ts  ou
cou	tsʰ  ou
sou	s  ou
ban	p an
pan	pʰ an
man	m an
fan	f an
dan	t an
tan	tʰ an
nan	n an
lan	l an
gan	k an
kan	kʰ an
han	x an
zhan	tʂ an
chan	tʂʰ an
shan	ʂ an
ran	ɻ an
zan	ts an
can	tsʰ an
san	s an
ben	p ən
pen	pʰ ən
men	m ən
fen	f ən
den	t ən
ten	tʰ ən
nen	n ən
len	l ən
gen	k ən
ken	kʰ ən
hen	x ən
zhen	tʂ ən
chen	tʂʰ ən
shen	ʂ ən
ren	ɻ ən
zen	ts ən
cen	tsʰ ən
sen	s ən
bang	p aŋ
pang	pʰ aŋ
mang	m aŋ
fang	f aŋ
dang	t aŋ
tang	tʰ aŋ
nang	n aŋ
lang	l aŋ
gang	k aŋ
kang	kʰ aŋ
hang	x aŋ
zhang	tʂ aŋ
chang	tʂʰ aŋ
shang	ʂ aŋ
rang	ɻ aŋ
zang	ts aŋ
cang	tsʰ aŋ
sang	s aŋ
beng	p ən
peng	pʰ ən
meng	m ən
feng	f ən
deng	t ən
teng	tʰ ən
neng	n ən
leng	l ən
geng	k ən
keng	kʰ ən
heng	x ən
zheng	tʂ ən
cheng	tʂʰ ən
sheng	ʂ ən
reng	ɻ ən
zeng	ts ən
ceng	tsʰ ən
seng	s ən
bi	p i
pi	pʰ i
mi	m i
fi	f i
di	t i
ti	tʰ i
ni	n i
li	l i
gi	k i
ki	kʰ i
hi	x i
ji	tɕ i
qi	tɕʰ i
xi	ɕ i
bia	p ia
pia	pʰ ia
mia	m ia
fia	f ia
dia	t ia
tia	tʰ ia
nia	n ia
lia	l ia
gia	k ia
kia	kʰ ia
hia	x ia
jia	tɕ ia
qia	tɕʰ ia
xia	ɕ ia
bio	p i au
pio	pʰ i au
mio	m i au
fio	f i au
dio	t i au
tio	tʰ i au
nio	n i au
lio	l i au
gio	k i au
kio	kʰ i au
hio	x i au
jio	tɕ i au
qio	tɕʰ i au
xio	ɕ i au
bie	p ie
pie	pʰ ie
mie	m ie
fie	f ie
die	t ie
tie	tʰ ie
nie	n ie
lie	l ie
gie	k ie
kie	kʰ ie
hie	x ie
jie	tɕ ie
qie	tɕʰ ie
xie	ɕ ie
biai	p i ai
piai	pʰ i ai
miai	m i ai
fiai	f i ai
diai	t i ai
tiai	tʰ i ai
niai	n i ai
liai	l i ai
giai	k i ai
kiai	kʰ i ai
hiai	x i ai
jiai	tɕ i ai
qiai	tɕʰ i ai
xiai	ɕ i ai
biao	p i au
piao	pʰ i au
miao	m i au
fiao	f i au
diao	t i au
tiao	tʰ i au
niao	n i au
liao	l i au
giao	k i au
kiao	kʰ i au
hiao	x i au
jiao	tɕ i au
qiao	tɕʰ i au
xiao	ɕ i au
biu	p i ou
piu	pʰ i ou
miu	m i ou
fiu	f i ou
diu	t i ou
tiu	tʰ i ou
niu	n i ou
liu	l i ou
giu	k i ou
kiu	kʰ i ou
hiu	x i ou
jiu	tɕ i ou
qiu	tɕʰ i ou
xiu	ɕ i ou
bian	p i ɛn
pian	pʰ i ɛn
mian	m i ɛn
fian	f i ɛn
dian	t i ɛn
tian	tʰ i ɛn
nian	n i ɛn
lian	l i ɛn
gian	k i ɛn
kian	kʰ i ɛn
hian	x i ɛn
jian	tɕ i ɛn
qian	tɕʰ i ɛn
xian	ɕ i ɛn
bin	p in
pin	pʰ in
min	m in
fin	f in
din	t in
tin	tʰ in
nin	n in
lin	l in
gin	k in
kin	kʰ in
hin	x in
jin	tɕ in
qin	tɕʰ in
xin	ɕ in
biang	p i aŋ
piang	pʰ i aŋ
miang	m i aŋ
fiang	f i aŋ
diang	t i aŋ
tiang	tʰ i aŋ
niang	n i aŋ
liang	l i aŋ
giang	k i aŋ
kiang	kʰ i aŋ
hiang	x i aŋ
jiang	tɕ i aŋ
qiang	tɕʰ i aŋ
xiang	ɕ i aŋ
bing	p iŋ
ping	pʰ iŋ
ming	m iŋ
fing	f iŋ
ding	t iŋ
ting	tʰ iŋ
ning	n iŋ
ling	l iŋ
ging	k iŋ
king	kʰ iŋ
hing	x iŋ
jing	tɕ iŋ
qing	tɕʰ iŋ
xing	ɕ iŋ
bu	p u
pu	pʰ u
mu	m u
fu	f u
du	t u
tu	tʰ u
nu	n u
lu	l u
gu	k u
ku	kʰ u
hu	x u
ju	tɕ y
qu	tɕʰ y
xu	ɕ y
zhu	tʂ u
chu	tʂʰ u
shu	ʂ u
ru	ɻ u
zu	ts u
cu	tsʰ u
su	s u
bua	p ua
pua	pʰ ua
mua	m ua
fua	f ua
dua	t ua
tua	tʰ ua
nua	n ua
lua	l ua
gua	k ua
kua	kʰ ua
hua	x ua
jua	tɕ ua
qua	tɕʰ ua
xua	ɕ ua
zhua	tʂ ua
chua	tʂʰ ua
shua	ʂ ua
rua	ɻ ua
zua	ts ua
cua	tsʰ ua
sua	s ua
buo	p uo
puo	pʰ uo
muo	m uo
fuo	f uo
duo	t uo
tuo	tʰ uo
nuo	n uo
luo	l uo
guo	k uo
kuo	kʰ uo
huo	x uo
juo	tɕ uo
quo	tɕʰ uo
xuo	ɕ uo
zhuo	tʂ uo
chuo	tʂʰ uo
shuo	ʂ uo
ruo	ɻ uo
zuo	ts uo
cuo	tsʰ uo
suo	s uo
buai	p u ai
puai	pʰ u ai
muai	m u ai
fuai	f u ai
duai	t u ai
tuai	tʰ u ai
nuai	n u ai
luai	l u ai
guai	k u ai
kuai	kʰ u ai
huai	x u ai
juai	tɕ u ai
quai	tɕʰ u ai
xuai	ɕ u ai
zhuai	tʂ u ai
chuai	tʂʰ u ai
shuai	ʂ u ai
ruai	ɻ u ai
zuai	ts u ai
cuai	tsʰ u ai
suai	s u ai
bui	p u ei
pui	pʰ u ei
mui	m u ei
fui	f u ei
dui	t u ei
tui	tʰ u ei
nui	n u ei
lui	l u ei
gui	k u ei
kui	kʰ u ei
hui	x u ei
jui	tɕ u ei
qui	tɕʰ u ei
xui	ɕ u ei
zhui	tʂ u ei
chui	tʂʰ u ei
shui	ʂ u ei
rui	ɻ u ei
zui	ts u ei
cui	tsʰ u ei
sui	s u ei
buan	p u an
puan	pʰ u an
muan	m u an
fuan	f u an
duan	t u an
tuan	tʰ u an
nuan	n u an
luan	l u an
guan	k u an
kuan	kʰ u an
huan	x u an
juan	tɕ y ɛn
quan	tɕʰ y ɛn
xuan	ɕ y ɛn
zhuan	tʂ u an
chuan	tʂʰ u an
shuan	ʂ u an
ruan	ɻ u an
zuan	ts u an
cuan	tsʰ u an
suan	s u an
bun	p u ən
pun	pʰ u ən
mun	m u ən
fun	f u ən
dun	t u ən
tun	tʰ u ən
nun	n u ən
lun	l u ən
gun	k u ən
kun	kʰ u ən
hun	x u ən
jun	tɕ yn
qun	tɕʰ yn
xun	ɕ yn
zhun	tʂ u ən
chun	tʂʰ u ən
shun	ʂ u ən
run	ɻ u ən
zun	ts u ən
cun	tsʰ u ən
sun	s u ən
buang	p u aŋ
puang	pʰ u aŋ
muang	m u aŋ
fuang	f u aŋ
duang	t u aŋ
tuang	tʰ u aŋ
nuang	n u aŋ
luang	l u aŋ
guang	k u aŋ
kuang	kʰ u aŋ
huang	x u aŋ
juang	tɕ u aŋ
quang	tɕʰ u aŋ
xuang	ɕ u aŋ
zhuang	tʂ u aŋ
chuang	tʂʰ u aŋ
shuang	ʂ u aŋ
ruang	ɻ u aŋ
zuang	ts u aŋ
cuang	tsʰ u aŋ
suang	s u aŋ
bong	p ʊŋ
pong	pʰ ʊŋ
mong	m ʊŋ
fong	f ʊŋ
dong	t ʊŋ
tong	tʰ ʊŋ
nong	n ʊŋ
long	l ʊŋ
gong	k ʊŋ
kong	kʰ ʊŋ
hong	x ʊŋ
zhong	tʂ ʊŋ
chong	tʂʰ ʊŋ
shong	ʂ ʊŋ
rong	ɻ ʊŋ
zong	ts ʊŋ
cong	tsʰ ʊŋ
song	s ʊŋ
bv	p y
byu	p y
pv	pʰ y
pyu	pʰ y
mv	m y
myu	m y
fv	f y
fyu	f y
dv	t y
dyu	t y
tv	tʰ y
tyu	tʰ y
nv	n y
nyu	n y
lv	l y
lyu	l y
gv	k y
gyu	k y
kv	kʰ y
kyu	kʰ y
hv	x y
hyu	x y
jv	tɕ y
jyu	tɕ y
qv	tɕʰ y
qyu	tɕʰ y
xv	ɕ y
xyu	ɕ y
zhv	tʂ y
zhyu	tʂ y
chv	tʂʰ y
chyu	tʂʰ y
shv	ʂ y
shyu	ʂ y
rv	ɻ y
ryu	ɻ y
zv	ts y
zyu	ts y
cv	tsʰ y
cyu	tsʰ y
sv	s y
syu	s y
bve	p ye
bue	p ye
pve	pʰ ye
pue	pʰ ye
mve	m ye
mue	m ye
fve	f ye
fue	f ye
dve	t ye
due	t ye
tve	tʰ ye
tue	tʰ ye
nve	n ye
nue	n ye
lve	l ye
lue	l ye
gve	k ye
gue	k ye
kve	kʰ ye
kue	kʰ ye
hve	x ye
hue	x ye
jve	tɕ ye
jue	tɕ ye
qve	tɕʰ ye
que	tɕʰ ye
xve	ɕ ye
xue	ɕ ye
zhve	tʂ ye
zhue	tʂ ye
chve	tʂʰ ye
chue	tʂʰ ye
shve	ʂ ye
shue	ʂ ye
rve	ɻ ye
rue	ɻ ye
zve	ts ye
zue	ts ye
cve	tsʰ ye
cue	tsʰ ye
sve	s ye
sue	s ye
biong	p i ʊŋ
piong	pʰ i ʊŋ
miong	m i ʊŋ
fiong	f i ʊŋ
diong	t i ʊŋ
tiong	tʰ i ʊŋ
niong	n i ʊŋ
liong	l i ʊŋ
giong	k i ʊŋ
kiong	kʰ i ʊŋ
hiong	x i ʊŋ
jiong	tɕ i ʊŋ
qiong	tɕʰ i ʊŋ
xiong	ɕ i ʊŋ
zhiong	tʂ i ʊŋ
chiong	tʂʰ i ʊŋ
shiong	ʂ i ʊŋ
riong	ɻ i ʊŋ
ziong	ts i ʊŋ
ciong	tsʰ i ʊŋ
siong	s i ʊŋ
a	a
o	o
e	ɤ
ai	ai
ei	ei
ao	au
ou	 ou
an	an
en	ən
ang	aŋ
ong	ʊŋ
eng	əŋ
er	aɚ
i	i
u	u
v	y
yi	i
wu	u
yu	y
ya	ia
ia	ia
yo	i au
io	i au
ye	ie
ie	ie
yai	i ai
iai	i ai
yao	i au
iao	i au
you	i ou
iou	i ou
yan	i ɛn
ian	i ɛn
yin	in
in	in
yang	i aŋ
iang	i aŋ
ying	iŋ
ing	iŋ
wa	ua
ua	ua
wo	uo
uo	uo
wai	u ai
uai	u ai
wei	u ei
wui	u ei
ui	u ei
wan	u an
uan	u an
wen	u ən
uen	u ən
wang	u aŋ
uang	u aŋ
weng	u əŋ
wong	ʊŋ
yue	ye
ue	ye
yve	ye
ve	ye
yuan	y ɛn
van	y ɛn
yun	yn
vn	yn
yong	i ʊŋ
iong	i ʊŋ
